markotny - romantyk
starować - trasować
kastrować - skartować
powrotny - potworny
tarować - ratować
składowy - słodkawy
optyczny - poczytny
dośrubowywać - odśrubowywać
wagarować - agrawować
odstępny - dostępny
doszorować - odszorować
obdarty - brodaty
tłokować - kotłować
solowy - losowy
adoptować - podatować
zamurować - mazurować
sumowy - musowy
doskakiwać - odskakiwać
topliwy - potliwy
fosforanować - nafosforować
wabny - bawny
matować - tamować
kaszlować - szaklować
kaszlować - szkalować
kaszlować - szlakować
wygarbować - wybagrować
obrazkowy - zarobkowy
zyskowny - szykowny
bagrować - garbować
rozradować - rozdarować
pikować - okpiwać
startować - tastrować
startować - stratować
zamienny - naziemny
rozpasany - oszarpany
spointować - stopniować
zakapować - zapakować
szumować - zsumować
balować - labować
klinować - niklować
raczkować - karczować
tatuować - atutować
porachować - poharcować
odmagnesowywać - domagnesowywać
kopulować - kupolować
kostyczny - toksyczny
pasterzować - przetasować
odhodować - dohodować
laskowy - klasowy
kapslować - skalpować
wyżny - żywny
kantować - tankować
przerafować - przearfować
korować - rokować
linowy - oliwny
dowojować - odwojować
okres - ksero
frezować - zrefować
odminować - dominować
parawan - naprawa
odśpiewywać - dośpiewywać
wyatutować - wytatuować
wektor - wtorek
galeria - alergia
laszować - szalować
laszować - zlasować
do - od
obły - było
szaklować - szkalować
szaklować - szlakować
domurować - odmurować
domurować - umordować
im - mi
roszować - szorować
petarda - adapter
no - on
konserwować - konwersować
odcelowy - docelowy
maszerować - szamerować
lawetować - waletować
tyli - lity
niemodny - odmienny
narcyz - czarny
zdeklarowany - kalendarzowy
doprasowywać - odprasowywać
odpakować - dopakować
domeldować - odmeldować
stopować - psotować
sławny - własny
durny - rudny
szumny - muszny
wyratować - wytarować
odżyłować - dożyłować
zabarkować - zabrakować
zabarkować - zakarbować
poadresować - odseparować
wyszamerować - wymaszerować
basztowy - sztabowy
zorywać - ryzować
dobudowywać - odbudowywać
workować - rowkować
koturnowy - konturowy
skatować - taksować
odmalowywać - domalowywać
odtransportować - dotransportować
odszywać - doszywać
zapasywać - zasapywać
wykarbować - wybrakować
odgrzebywać - dogrzebywać
dożyłowywać - odżyłowywać
wprasować - sprawować
skarpeta - pasterka
bocian - obcina
aportować - poratować
zachodni - nachodzi
domeldowywać - odmeldowywać
sparować - prasować
skórzany - zaskórny
burtować - turbować
dopracowywać - odpracowywać
tonować - notować
dostępować - odstępować
wynotować - wytonować
reakcyjny - kreacyjny
kratkować - kartkować
hiacynt - chityna
donajmować - odnajmować
zsanować - szanować
porabować - aprobować
odratować - odtarować
karze - zerka
karze - rzeka
skonturować - konstruować
bryka - rybak
bryka - rybka
pilny - lipny
szkalować - szlakować
wywrotny - wytworny
szutrować - rusztować
popakować - pokapować
dopisywać - odpisywać
spory - syrop
biodrowy - drobiowy
dowiązywać - odwiązywać
algorytmiczny - logarytmiczny
odnośny - donośny
tapirować - piratować
odsapywać - odpasywać
dopracować - odpracować
obdarować - obradować
pokrapywać - paprykować
dośrodkowy - odśrodkowy
dokazować - zakodować
posforować - poforsować
zależny - żelazny
mimo - moim
pasynkować - napyskować
darować - radować
darować - adrować
taklować - talkować
ekran - nerka
ekran - ranek
brogować - borgować
kazualny - kauzalny
torpedować - deportować
odgotowywać - dogotowywać
koczować - oczkować
zabrakować - zakarbować
dośrubować - odśrubować
plakować - klapować
szarfować - farszować
odfermentować - dofermentować
bumelować - umeblować
stropowy - sportowy
kapować - pakować
prostować - sportować
prostować - stropować
zamatować - zatamować
niezawodny - nawiedzony
sakralny - skalarny
lamować - malować
pomaskować - posmakować
sonet - notes
dokłamywać - odkłamywać
odkorować - korodować
odbudować - dobudować
odszukiwać - doszukiwać
domurowywać - odmurowywać
rafować - arfować
burdel - dubler
doszlifować - odszlifować
tresować - sterować
kulowy - lukowy
styropian - strapiony
zanalizować - nazalizować
rokadowy - akordowy
kartować - tarkować
kartować - kratować
odmalować - domalować
odmurować - umordować
poobszywać - poszybować
krzemowy - wrzekomy
szalować - zlasować
okratować - karotować
oblamować - obmalować
rdzeniowy - niezdrowy
dopompować - odpompować
paskować - spakować
paskować - skapować
cwałować - wcałować
posterować - stoperować
suplować - pulsować
grodowy - drogowy
pokorny - okropny
odsiadywać - dosiadywać
rentować - trenować
czapkować - paczkować
urgować - rugować
szpaltować - sztaplować
flirtować - filtrować
darowizna - rozwadnia
uporny - ponury
wypakować - wykapować
tarkować - kratować
szturmować - musztrować
plakatowy - klapowaty
aplikować - palikować
wytańcować - tańcowywać
dopiłować - odpiłować
odrachować - dorachować
kowalny - wokalny
kowalny - klanowy
rekwizyt - wietrzyk
odwoływać - wydołować
odwoływać - dowoływać
aspekt - pestka
odrysowywać - dorysowywać
odgotować - dogotować
nerka - ranek
dolegiwać - odlegiwać
rapować - parować
odczekiwać - doczekiwać
ospały - opasły
szybować - obszywać
odpakowywać - dopakowywać
pyskować - skopywać
domowy - modowy
paktować - kaptować
kłosować - skołować
arbuz - burza
odpytywać - dopytywać
dorysować - odrysować
dożywać - odżywać
odpukiwać - dopukiwać
odchowywać - dochowywać
podrzemywać - zdeprymować
remont - monter
wcałowywać - wycwałować
szoferować - zesforować
zamaskować - zasmakować
kaustyczny - akustyczny
opłacalny - całopalny
konwersacyjny - konserwacyjny
caplować - palcować
dokopywać - odkopywać
animować - mianować
odsługiwać - dosługiwać
bytni - bitny
odkupywać - dokupywać
spakować - skapować
remontować - mentorować
brakować - karbować
sportować - stropować
zakopywać - pokazywać
podarować - odparować
wredny - drewny
wypikować - pokiwywać
odsypywać - dosypywać
rany - nary
odholować - doholować
argonowy - organowy
wydołować - dowoływać
makrela - reklama
rautować - uratować
tastrować - stratować
zerka - rzeka
talerzować - zalterować
smakować - maskować
bagrowy - grabowy
odprasować - doprasować
rozjadły - dojrzały
demolować - modelować
rozkleja - kolejarz
doczytywać - odczytywać
robotny - obrotny
odgarbować - dogarbować
parobkować - pokarbować
nieodstępny - niedostępny
zawirować - zwariować
odpasować - dopasować
szykanować - naszykować
wargowy - gwarowy
owładywać - wyładować
wokalny - klanowy
dogadywać - odgadywać
musować - sumować
radować - adrować
odrodny - dorodny
tokować - kotować
wysapywać - wypasywać
odmagnesować - domagnesować
niewytworny - niewywrotny
zaanimować - zamianować
zarubrykować - karburyzować
sporadyczny - rapsodyczny
dorachowywać - odrachowywać
zielarski - izraelski
przysapywać - przypasywać
czujny - juczny
wsypowy - wyspowy
zarekomendować - zakomenderować
rybak - rybka
rekomendować - komenderować
harcować - rachować
